SRL	KEYWORD1
PWM_MAX_VALUE	LITERAL1

Motor	KEYWORD1
start	KEYWORD2
stop	KEYWORD2
setDirection	KEYWORD2
getDirection	KEYWORD2
forwards	KEYWORD2
backwards	KEYWORD2
FORWARD	LITERAL1
BACKWARD	LITERAL1
getForwardPin	KEYWORD2
getBackwardPin	KEYWORD2
getPwmPin	KEYWORD2
getSpeed	KEYWORD2
setSpeed	KEYWORD2

Angle	KEYWORD1
add	KEYWORD2
subtract	KEYWORD2
setAngle	KEYWORD2
getSize	KEYWORD2

Vector	KEYWORD1
addition	KEYWORD2
add	KEYWORD2
getX	KEYWORD2
getY	KEYWORD2
getLength	KEYWORD2
setX	KEYWORD2
setY	KEYWORD2

Rover	KEYWORD1
forward	KEYWORD2
backward	KEYWORD2
turnRight	KEYWORD2
turnLeft	KEYWORD2
goTo	KEYWORD2
turnTo	KEYWORD2
stop	KEYWORD2
getDirection	KEYWORD2
setDirection	KEYWORD2
getX	KEYWORD2
getY	KEYWORD2
setX	KEYWORD2
setY	KEYWORD2
calcGyroOffsets	KEYWORD2
CORRECT_MOTORS_INTERVAL	LITERAL1
UPDATE_POSITION_INTERVAL	LITERAL1
correctMotors	KEYWORD2
updatePosition	KEYWORD2
setAccelGyro	KEYWORD2
setLeftEncoder	KEYWORD2
setRightEncoder	KEYWORD2
getAccelGyro	KEYWORD2
getLeftEncoder	KEYWORD2
getRightEncoder	KEYWORD2
getRightMotor	KEYWORD2
getLeftMotor	KEYWORD2

I2C	KEYWORD1
I2CDevice	KEYWORD2
writeBytes	KEYWORD2
writeByte	KEYWORD2
writeBits	KEYWORD2
readBytes	KEYWORD2
readByte	KEYWORD2
readInt16_t	KEYWORD2
getAddress	KEYWORD2
setAddress	KEYWORD2

MPU6050	KEYWORD1
initialize	KEYWORD2
setAccelSensitivity	KEYWORD2
setGyroSensitivity	KEYWORD2
getRawAccelX	KEYWORD2
getRawAccelY	KEYWORD2
getRawAccelZ	KEYWORD2
getRawGyroX	KEYWORD2
getRawGyroY	KEYWORD2
getRawGyroZ	KEYWORD2
getRawTemp	KEYWORD2
getAccelX	KEYWORD2
getAccelY	KEYWORD2
getAccelZ	KEYWORD2
getTemp	KEYWORD2
getAccelCoeff	KEYWORD2
setAccelCoeff	KEYWORD2
getGyroCoeff	KEYWORD2
setGyroCoeff	KEYWORD2
getAccelXOffset	KEYWORD2
getAccelYOffset	KEYWORD2
getAccelZOffset	KEYWORD2
setAccelXOffset	KEYWORD2
setAccelYOffset	KEYWORD2
setAccelZOffset	KEYWORD2
getGyroXOffset	KEYWORD2
getGyroYOffset	KEYWORD2
getGyroZOffset	KEYWORD2
setGyroXOffset	KEYWORD2
setGyroYOffset	KEYWORD2
setGyroZOffset	KEYWORD2
setAccelOffsets	KEYWORD2
setGyroOffsets	KEYWORD2
calcGyroOffsets	KEYWORD2
calcAccelOffsets	KEYWORD2
getRawAccelXMedian	KEYWORD2
getRawAccelYMedian	KEYWORD2
getRawAccelZMedian	KEYWORD2
getAccelXMedian	KEYWORD2
getAccelYMedian	KEYWORD2
getAccelZMedian	KEYWORD2
getRawGyroXMedian	KEYWORD2
getRawGyroYMedian	KEYWORD2
getRawGyroZMedian	KEYWORD2
getGyroXMedian	KEYWORD2
getGyroYMedian	KEYWORD2
getGyroZMedian	KEYWORD2
X_UP	LITERAL1
X_DOWN	LITERAL1
Y_UP	LITERAL1
Y_DOWN	LITERAL1
Z_DOWN	LITERAL1
Z_UP	LITERAL1

SRF05	KEYWORD1
ping	KEYWORD2
convertCm	KEYWORD2
convertUs	KEYWORD2
pingCm	KEYWORD2
pingMm	KEYWORD2
pingMedian	KEYWORD2
pingMedianCm	KEYWORD2
pingMedianMm	KEYWORD2
convertMm	KEYWORD2
getTriggerPin	KEYWORD2
getEchoPin	KEYWORD2
setTriggerPin	KEYWORD2
setEchoPin	KEYWORD2
getMaxDistance	KEYWORD2
setMaxDistance	KEYWORD2

Tank	KEYWORD1
start	KEYWORD2
stop	KEYWORD2
faceLeft	KEYWORD2
faceRight	KEYWORD2
setDirection	KEYWORD2
forwards	KEYWORD2
backwards	KEYWORD2
FORWARD	LITERAL1
BACKWARD	LITERAL1
LEFT	LITERAL1
RIGHT	LITERAL1
getDirection	KEYWORD2
getLeftMotor	KEYWORD2
getRightMotor	KEYWORD2
setUnifiedSpeed	KEYWORD2

getMedian	KEYWORD2
getAverage	KEYWORD2

ENCODER_USE_INTERRUPTS	LITERAL1
ENCODER_OPTIMIZE_INTERRUPTS	LITERAL1
ENCODER_DO_NOT_USE_INTERRUPTS	LITERAL1
readCm	KEYWORD2
readMm	KEYWORD2
writeCm	KEYWORD2
writeMm	KEYWORD2
convertSteps	KEYWORD2
convertCm	KEYWORD2

JGY370	KEYWORD1

rgbled	KEYWORD1
compareColor	KEYWORD2
setColor	KEYWORD2
getColor	KEYWORD2
turnOff	KEYWORD2
turnOn	KEYWORD2
setState	KEYWORD2
getState	KEYWORD2
RED	LITERAL1
GREEN	LITERAL1
BLUE	LITERAL1
WHITE	LITERAL1
ON	LITERAL1
OFF	LITERAL1

Buzzer	KEYWORD1
turnOff	KEYWORD2
turnOn	KEYWORD2
setState	KEYWORD2
getState	KEYWORD2
ON	LITERAL1
OFF	LITERAL1

BMP280	KEYWORD1
setOversampling	KEYWORD2
setMode	KEYWORD2
getTemperature	KEYWORD2
getPressure	KEYWORD2
getAltitude	KEYWORD2
getMedianTemperature	KEYWORD2
getMedianPressure	KEYWORD2
getMedianAltitude	KEYWORD2
ULTRA_LOW_POWER	LITERAL1
LOW_POWER	LITERAL1
STANDARD_RES	LITERAL1
HIGH_RES	LITERAL1
ULTRA_HIGH_RES	LITERAL1
SLEEP_MODE	LITERAL1
NORMAL_MODE	LITERAL1
FORCED_MODE	LITERAL1
